T-----------------------7
|     k      k          |
|  T---   --   --    k  |
|  |  k                 |
|k |      k     k       |
|  |  T---   k          |
|  | k|         k       |
|  L--J  k              |
| k        ------       |
|  ---           k 
|        k    k      
|   k      -------7     |
|        k      k |     |
|         T---          |
|         |       |     |
|         |       |     |
|         L-------J     |   
|   k         k         |
L-----------------------J
